00000000000003
00000000000003
00000000000003
00000000000003
00000000000003
00000000000003
00000000000003
00000000000003
00000000000003
00000000000003
00000000000003
00000000000003
00000000000003
00006::::80003
00003$||*40003
00003400340003
00003400340003
00003%::#40003
00005||||70003
00000000000003
00000000000003
00000000000003
00000000000003
00000000000003
00000000000003
00000000000003
00000000000003
00000000000003
00000000000003
00000000000003
00000000000003
00000000000003
