40000000000003
40000000000003
40000000000003
40000000000003
40000000000003
40000000000003
40000000000003
40000000000003
40000000000003
40000000000003
40000000000003
40000000000003
40000000000003
40006::::80003
40003$||*40003
40003400340003
40003400340003
40003%::#40003
40005||||70003
40000000000003
40000000000003
40000000000003
40000000000003
40000000000003
40000000000003
40000000000003
40000000000003
40000000000003
4 0000000000 3
%::::8006::::#
     4003
     4003
