$||||||||||||*
40000000000003
40000000000003
40000000000003
40000000000003
40000000000003
40000000000003
40000000000003
40000000000003
40000000000003
40000000000003
40000000000003
%:::8000000003
    4000000003
||* %:::806::#
003     403
005|||||705||*
80000000000003
40000000000003
40000000000003
40000000000003
40000000000003
40000000000003
40000000000003
40000000000003
40000000000003
40000000000003
40000000000003
40000000000003
40000000000003
40000000000003
%::::::::::::#
