$||||7005||||*
40000000000003
40000002000003
40000000000003
40000000000003
40000000#00003
40000000000003
40000000000003
40000000000003
40000000000003
40000000000003
40000000000003
40000000000003
40000000000003
70000000000005
00000000000000
00000000000000
80000000000006
40000000000003
40000000000003
40000000000003
40000000000003
40000000000003
40000000000003
40000000000003
40000000000003
40000000000003
40000000000003
40000000000003
40000000000003
40000000000003
%::::8006::::#
